EA ./textures/wall_E.xpm
SO ./textures/wall_S.xpm
WE ./textures/wall_W.xpm
NO ./textures/wall_N.xpm
PP ./texturesbonus/porte.xpm
PC ./texturesbonus/porteopen.xpm
DD ./texturesbonus/duff.xpm

F 96,96,96
C 127,177,252

111111            1111111111
121121            1000000001
100001            1001010001
100001            1221110001
100001  11111     1111 10001
151001  10S01          10001
111001  10001          11101
100001  10001          10001
100001  10001          11101
100111  10001          10001
100001  10001     1111110001
1000011110001     1000000001
1010000000001     1000111111
10100000000011111110001
11111110000000000000001
      11000111111110001111111
      1200021     10000000021
      1111111     11111111111
