NO ./textures/wall_N.xpm
SO ./textures/wall_S.xpm
WE ./textures/wall_W.xpm
EA ./textures/wall_E.xpm

F 96,96,96
C 127,177,255

11 111111
111100001
100000001
100000001
100000001
1000000011
1000000001
1000000011
100000001
100111001
1001 1001
100111001
100000001
100000001
1000000011
1000000001
1000000001
100000N001
1000000001
1000000011
1000001011
1000000011
100000001
100000001
11111111